MINISTÉRIOS 29/6/2005
Autor: 
Editoria: INFORMÁTICA Página: F12
Edição: São Paulo Jun 29, 2005
Seção: 110 SITES SELECIONADOS
Observações: SUB-RETRANCA
Assuntos Principais: INTERNET; SITE; SERVIÇO PÚBLICO; ÓRGÃO; GOVERNO FEDERAL; GOVERNO LULA; MINISTÉRIO
MINISTÉRIOS
Agricultura, Pecuária e Abastecimento - dados institucionais, serviços e consulta a processos:
www.agricultura.gov.br
Casa Civil da Presidência da República - atos do governo, documentos e notícias:
www.presidencia.gov.br/casacivil
Cidades - notícias e informações sobre programas e ações: www.cidades.gov.br
Ciência e Tecnologia - agenda do ministro, concursos e notícias: www.mct.gov.br
Comunicações - links para todos os órgãos de comunicação oficiais: www.mc.gov.br
Controladoria-Geral da União - denúncias, ouvidoria e relatórios: www.presidencia.gov.br/cgu
Cultura - projetos, instituições vinculadas e ações: www.cultura.gov.br
Desenvolvimento Agrário - leis, perguntas e respostas, notícias: www.mda.gov.br
Desenvolvimento, Indústria e Comércio Exterior - agenda, cartilha do exportador e notícias:
www.desenvolvimento.gov.br
Desenvolvimento Social e Combate à Fome - informações sobre os programas sociais desenvolvidos: www.assistenciasocial.gov.br
Educação - dados sobre educação e financiamento universitário: www.mec.gov.br
Esporte - informações institucionais, ações do Ministério e ouvidoria: www.esporte.gov.br
Exército Brasileiro - informações sobre escolas do exército e carreira: www.exercito.gov.br
Fazenda - orçamento, indicadores econômicos e bancos federais: www.fazenda.gov.br
 
Força Aérea Brasileira - histórias, projetos e dicas de segurança: www.fab.mil.br
Integração Nacional - ouvidoria e pedido de recursos da Defesa Civil: www.integracao.gov.br
Justiça - denúncias, combate à pirataria e certidões on-line: www.mj.gov.br
Marinha do Brasil - concursos, notícias e condições do tempo: www.mar.mil.br
Meio Ambiente - temas relacionados, programas ambientais e editais: www.mma.gov.br
Minas e Energia - dicas para o uso racional de recursos energéticos: www.mme.gov.br
Planejamento, Orçamento e Gestão - assuntos econômicos, responsabilidade fiscal e orçamento:
www.planejamento.gov.br
Previdência Social - atendimento on-line ao trabalhador (com e sem registro) e ao empregador:
www.mpas.gov.br
Relações Exteriores - política externa e atendimento consular: www.mre.gov.br
Saúde - desenvolvimento científico e campanhas públicas de saúde: www.saude.gov.br
Trabalho e Emprego - informações para trabalhadores, empregadores e jovens em busca de emprego: www.mte.gov.br
Transportes - dados sobre o transporte no Brasil e mapas: www.transportes.gov.br
Turismo - calendário de festas brasileiras e turismo no país: www.turismo.gov.br
