OUTROS ESTADOS 29/6/2005
Autor: 
Editoria: INFORMÁTICA Página: F12
Edição: São Paulo Jun 29, 2005
Seção: 110 SITES SELECIONADOS
Observações: SUB-RETRANCA
Assuntos Principais: INTERNET; SITE; SERVIÇO PÚBLICO; ÓRGÃO; GOVERNO ESTADUAL; ESTADO
OUTROS ESTADOS
Acre - secretarias, editais, concursos e serviços para a população: www.ac.gov.br
Alagoas - informações e serviços do governo on-line: www.itec.al.gov.br
Amapá - notícias e prestação de contas do governo do Amapá: www.amapa.gov.br
Amazonas - cultura, turismo e serviços ao cidadão: www.amazonas.am.gov.br
Bahia - serviços on-line, informações turísticas e culturais: www.bahia.ba.gov.br
Ceará - concursos públicos, órgãos do governo e guia de serviços on-line: www.ceara.gov.br
Espírito Santo - secretarias e órgãos do governo têm serviços na web: www.es.gov.br
Goiás - emissão de guias, de protocolos e de certidões negativas, entre outros:
www.vaptvupt.go.gov.br
Maranhão - serviços on-line, notícias e ouvidoria: www.ma.gov.br
Mato Grosso - serviços e guia de utilidade pública on-line: www.mt.gov.br
Mato Grosso do Sul - agência de notícias e serviços públicos das mais diversas áreas:
www.ms.gov.br
Minas Gerais - serviços públicos on-line, divididos por assunto: www.mg.gov.br
Pará - notícias, serviços, turismo e contato com o governador e a vice-governadora:
www.pa.gov.br
Paraíba - secretarias, turismo e prestação de serviços públicos: www.paraiba.pb.gov.br
Paraná - acesso aos principais serviços on-line na página inicial: www.pr.gov.br
Pernambuco - além de notícias, tem links para o Governo Digital e serviços on-line:
www.pe.gov.br
Piauí - secretarias de governo, notícias e serviços: www.pi.gov.br
Rio Grande do Norte - principais notícias e links para serviços públicos on-line: www.rn.gov.br
Rio Grande do Sul - biblioteca virtual e acesso a serviços do governo: www.scp.rs.gov.br
Rio de Janeiro - o destaque da página inicial são os serviços públicos on-line: www.governo.rj.gov.br
Rondônia - agenda do governador, download do Código Civil e vagas de emprego: www.rondonia.ro.gov.br
Roraima - informações sobre turismo e planejamento estratégico do Estado: www.seplan.rr.gov.br
Santa Catarina - serviços públicos on-line e mapa interativo de Santa Catarina: www.sc.gov.br
São Paulo - prestação de serviço, governo eletrônico e secretaria de governo: www.saopaulo.sp.gov.br
Sergipe - serviços fiscais e relacionados ao Detran: www.se.gov.br
Tocantins - turismo, notícias e cultura são os destaques: www.to.gov.br
