SÃO PAULO 29/6/2005
Autor: 
Editoria: INFORMÁTICA Página: F12
Edição: São Paulo Jun 29, 2005
Seção: 110 SITES SELECIONADOS
Observações: SUB-RETRANCA
Assuntos Principais: INTERNET; SITE; SERVIÇO PÚBLICO; ÓRGÃO; GOVERNO ESTADUAL; SÃO PAULO /ESTADO/
SÃO PAULO
Anhembi Turismo e Eventos - informações sobre o pavilhão, o palácio, o sambódromo e o auditório Elis Regina: anhembi.terra.com.br
Assembléia Legislativa de São Paulo - dados sobre os deputados estaduais e as comissões de trabalho: www.al.sp.gov.br
Câmara Municipal de São Paulo - vereadores do município de São Paulo e projetos aprovados:
www.camara.sp.gov.br
Centro Estadual de Educação Tecnológica Paula Souza (Ceeteps) - vestibulinho para 108 Escolas Técnicas Estaduais (ETEs) e 18 Faculdades de Tecnologia (Fatecs): www.ceeteps.br
Centro de Previsão do Tempo e Estudos Climáticos (Ceptec) - previsão do tempo, tábua de marés e monitoramento de chuvas: www.cptec.inpe.br
Companhia de Tecnologia de Saneamento Ambiental (Cetesb) - ensina a evitar a poluição da água, do ar e do solo: www.cetesb.sp.gov.br
Companhia de Desenvolvimento Habitacional Urbano (CDHU) - para mutuários e interessados em adquirir um imóvel: www.cdhu.sp.gov.br
Detran - licenciamento de veículos e pontos na carteira de habilitação: www.detran.sp.gov.br
Guia de Escolas Estaduais - escolas estaduais espalhadas pelo Estado: escola.edunet.sp.gov.br
Instituto de Pesos e Medidas (Ipem) - dicas sobre produtos controlados pelo órgão, como camisinhas, extintores de incêndio e botijões de gás: www.ipem.sp.gov.br
Junta Comercial de São Paulo - tira-dúvidas para integrantes de sociedades comerciais:
www.jucesp.sp.gov.br
Negócios Públicos - leis, decretos e licitações: www.negocios.sp.gov.br
Nossa Caixa - financiamento de bens e serviços: www.nossacaixa.com.br
Oficinas Culturais - programação das oficinas culturais: www.oficinasculturais.sp.gov.br
Ouvidoria - para reclamações sobre órgãos públicos: www.seade.gov.br/quadro-servpubl/indexouvid.html
Polícia Científica - mapa das áreas atendidas pelo Instituto Médico-Legal (IML) e pelo Instituto de Criminalística (IC): www.polcientifica.sp.gov.br
Polícia Civil - delegacia eletrônica permite prestar queixa on-line: www.policia-civ.sp.gov.br
Polícia Militar - serviço 190 on-line e dicas de segurança: www.polmil.sp.gov.br
Polícia Federal - informações sobre a emissão de passaporte e impressão de guia de pagamento:
www.dpf.gov.br
Posto Fiscal Eletrônico - impostos devidos ao governo estadual: www.pfe.fazenda.sp.gov.br
Poupatempo - postos de atendimento, serviços disponíveis e documentos necessários: www.poupatempo.sp.gov.br
Prefeitura de São Paulo - serviços on-line da prefeitura e notícias: www.prefeitura.sp.gov.br
Pregão Presencial - legislação e agenda de pregões: www.pregao.sp.gov.br
Procon - cartilhas, legislação e lista de empresas mais questionadas: www.procon.sp.gov.br
ProSangue - agendamento on-line de doação de sangue e tira-dúvidas: www.prosangue.com.br
Secretaria de Estado da Cultura - agenda dos centros culturais: www.cultura.sp.gov.br
Secretaria de Estado de Economia e Planejamento - orçamento do governo do Estado:
www.planejamento.sp.gov.br
Secretaria de Estado da Fazenda - notícias de processos, emissão de guias e restituição de impostos: www.fazenda.sp.gov.br
Secretaria de Segurança Pública (SSP) - permite fazer denúncias on-line: www.seguranca.sp.gov.br/site
SOS Cidadania - cidadania, direitos humanos e como denunciar atos de preconceito:
www.justica.sp.gov.br
Tribunal Regional Eleitoral (TRE) - dúvidas sobre processos eleitorais e urna eletrônica virtual:
www.tre-sp.gov.br
Universidade de São Paulo (USP) - informações sobre os cursos da principal universidade do país:
www.usp.br
Universidade Estadual Paulista (Unesp) - cursos da universidade espalhada pelo interior paulista:
www.unesp.br
Universidade Estadual de Campinas (Unicamp) - unidades e institutos, com seus respectivos cursos: www.unicamp.br
