O PT NO GOVERNO 11/7/2005
Autor: 
Editoria: BRASIL Página: A5
Edição: São Paulo Jul 11, 2005
Arte: QUADRO: O PT NO GOVERNO
Observações: SUB-RETRANCA
Vinheta/Chapéu: ESCÂNDALO DO "MENSALÃO"/ PARTIDO EM CRISE
Assuntos Principais: GOVERNO LULA; REFORMA MINISTERIAL; CRISE POLÍTICA; MENSALÃO; PT /PARTIDO/; MINISTÉRIO; SITUAÇÃO
O PT NO GOVERNO
OS MINISTÉRIOS E SECRETARIAS DO PARTIDO 
Casa Civil Dilma - Rousseff 
Cidades - Olívio Dutra 
Controladoria-Geral da União - Waldir Pires 
Comunicação de Governo - Luiz Gushiken 
Desenvolvimento Agrário - Miguel Rossetto 
Conselhão - Jaques Wagner 
Desenvolvimento Social - Patrus Ananias 
Direitos Humanos - Nilmário Miranda 
Fazenda - Antonio Palocci Filho 
Meio Ambiente - Marina Silva 
Pesca - José Fritsch 
Planejamento - Paulo Bernardo 
Política para as Mulheres - Nilcéa Freire 
Promoção da Igualdade Racial - Matilde Ribeiro 
Secretaria-Geral - Luiz Dulci 
Trabalho - Luiz Marinho 
OS MINISTÉRIOS QUE O PT PERDEU  
 . Previdência - Na primeira reforma ministerial, Ricardo Berzoini saiu para dar lugar a Amir Lando (PMDB). Hoje, Romero Jucá, também do PMDB, ocupa a pasta -e deve sair  
 . Combate à Fome e Assistência Social - as pastas foram fundidas em uma só, o Desenvolvimento Social  
 . Saúde - Humberto Costa foi substituído na última sexta por Saraiva Felipe (PMDB)  
 . Minas e Energia - Dilma Rousseff foi para a Casa Civil e assumiu Silas Rondeau, indicado pelo PMDB 
SITUAÇÃO INDEFINIDA  
 . Educação - Com a ida de Tarso Genro para a presidência do PT, a pasta fica vaga. Não se sabe ainda quem vai substituí-lo
