JORNAL 21 3/7/2005
Autor: 
Editoria: ILUSTRADA Página: E1
Edição: São Paulo Jul 3, 2005
Crédito Foto: Marlene Bergamo/Folha Imagem
Arte: QUADRO: JORNAL 21
Observações: SUB-RETRANCA; FICHA TÉCNICA
Assuntos Principais: TELEVISÃO; JORNALISMO; ESTRÉIA; REDE 21; LILIAN WITTE FIBE; PERFIL
JORNAL 21
APRESENTAÇÃO: LILLIAN WITTE FIBE
. ENFOQUE: análise e explicação das notícias
. COLUNISTAS: psicóloga Rosely Sayão (família), jornalistas Fernando Rodrigues (política/Brasília), Maria Cristina Frias (economia) e Mônica Bergamo (bastidores), todos da Folha
. EMISSORAS AFILIADAS: Rio de Janeiro e Brasília (poderá utilizar material da Rede Bandeirantes)
. CORRESPONDENTES INTERNACIONAIS: está fechando acordo para utilizar a rede internacional da BBC Brasil
. EQUIPE EM SÃO PAULO: “Ainda não contei, mas não posso me queixar”
CANAL: REDE 21
ESTRÉIA: AMANHÃ
EXIBIÇÃO: TODOS OS DIAS, DAS 22H ÀS 22H30 (COM LILLIAN DE SEGUNDA A SEXTA)
NOME COMPLETO: Lillian Witte Fibe
IDADE: 51
BAIRRO EM SÃO PAULO: Real Park
FORMAÇÃO: jornalismo na USP
CURRÍCULO: Folha, “Gazeta Mercantil”, “Jornal do Brasil”, Bandeirantes, Globo, SBT, Terra e UOL
ESTADO CIVIL: casada com o jornalista Alexandre Gambirasio
ALTURA: 1,67 m
PESO: “não digo nem morta”
LIVRO QUE ESTÁ LENDO: “tem uma pilha na minha cabeceira”
ÚLTIMO FILME A QUE ASSISTIU: “Menina de Ouro”
CABELEIREIRO: Mauro Freire (Carolina Ferraz, Ruth Cardoso, Malu Mader, Patrícia Pillar, Xuxa)
ESTILISTA: nenhum fixo
LAZER: Pinacoteca, Sala São Paulo, cinemas, teatros, apresentações da Osesp, “tudo para evitar os restaurantes e não engordar”
ATIVIDADE FÍSICA: ler quatro jornais na bicicleta ergométrica
VÍCIO: roer as cutículas, “mas ando sem tempo até para isso”
