NACIONAIS 27/7/2005
Autor: 
Editoria: INFORMÁTICA Página: F12
Edição: São Paulo Jul 27, 2005
Seção: 110 SITES SELECIONADOS
Observações: SUB-RETRANCA
Assuntos Principais: INTERNET; GASTRONOMIA; ENOLOGIA; VINICULTURA; VINICULTORA; ADEGA; VINHO; SITE
NACIONAIS
Adega Dani - oferece personalização de rótulos e venda on-line: www.vinhosadegadani.com.br
Angheben - de origem italiana, produz vinhos em Bento Gonçalves: www.angheben.com.br
Boscato - apresenta os produtos da marca e dá dicas de gastronomia: www.boscato.com.br
Casa Valduga - ensina a escolher o vinho, a conservá-lo e a abrir a garrafa na hora de servir:
www.casavalduga.com.br
Cavalleri - informações sobre a vinícola e seus vinhos e loja virtual: www.cavalleri.com.br
Cave de Amadeu - dados sobre espumantes, brancos e tintos produzidos pela vinícola:
www.amadeu.com.br
Cave de Pedra - produtos, histórico da vinícola e loja virtual: www.cavedepedra.com.br
Château Lacave - dicas de turismo na serra gaúcha e guia de degustação: www.chateaulacave.com.br
Conceição - receitas, agenda de cursos e loja on-line: www.vinhosdionysius.com.br
Cooperativa Aliança - apresentação dos produtos, que incluem vinhos, suco de uva e quentão:
www.vinhos-alianca.com.br
Cooperativa Aurora - linha de produtos e receitas de harmonização: www.vinicolaaurora.com.br
Cordelier - apresenta as linhas de vinhos da vinícola e tem loja on-line: www.cordelier.com.br
Dal Pizzol - produtos, receitas, dicas do enólogo e loja virtual: www.dalpizzol.com.br
Dom Candido - apresenta os vinhos da casa e tem loja on-line: www.domcandido.com.br
Don Giovanni - sugestões turísticas, informações sobre os produtos e dicas de degustação:
www.dongiovanni.com.br
Don Laurindo - informações sobre os produtos e lista de preços para compras na loja virtual:
www.donlaurindo.com.br
Fornasier - histórico e apresentação dos produtos. Pacotes de turismo para casamentos na montanha: www.vinhosfornasier.com.br
Marco Luigi - explica o processo de fabricação de vinhos, dá dicas de degustação e tem passeio virtual: www.marcoluigi.com.br
Marson - reportagens e dicas de harmonização: www.vinhosmarson.com.br
Miolo - uma das mais tradicionais marcas nacionais. Use a loja virtual para comprar on-line:
www.miolo.com.br
Monte Reale - vinhos e sucos da marca são apresentados no site. Tem receitas e informações sobre os benefícios do vinho à saúde: www.montereale.com.br
Panizzon - informações sobre os produtos da empresa, receitas e dicas de degustação:
www.panizzon.com.br
Peterlongo - famosa por seu espumante, dispõe ainda de vinhos e de sucos: www.peterlongo.com.br
Salton - dados sobre os vinhos e sobre sua elaboração, dicas e receitas de refeições e de coquetéis: www.salton.com.br
Sinuelo - apresentação dos produtos da empresa, receitas, curiosidades e dicas de enólogos:
www.sinuelo.com.br
Vallontano - informações sobre os produtos da marca e sobre o Vale dos Vinhedos, na serra gaúcha, onde são produzidos: www.vallontano.com.br
Valmarino - histórico e produtos da marca, além de loja on-line: www.valmarino.com.br
Velha Cantina - apresenta os vinhos da casa e indica a refeição ou alimento que combina com eles: www.velhacantina.com.br
Velho Museu - detalha a produção de vinhos comuns e biológicos: www.velhomuseu.com.br
Viapiana - dicas para os apreciadores e histórico da vinícola: www.vinhosviapiana.com.br
Vinícola Perini - personalização de rótulos dos vinhos da marca. Tem licor de grappa e suco de uva: www.casaperini.com.br
