O BÊ-Á-BÁ DA BEBIDA 11/8/2005
Autor: 
Editoria: TURISMO Página: F8
Edição: São Paulo Aug 11, 2005
Crédito Foto: Reprodução; Odilon Comodaro/Folha Imagem; Divulgação
Arte: QUADRO: O BÊ-Á-BÁ DA BEBIDA
Observações: SUB-RETRANCA
Assuntos Principais: TURISMO; CAFEICULTURA; CAFÉ; GASTRONOMIA
O BÊ-Á-BÁ DA BEBIDA
Blend: combinação de grãos de cafés que têm características complementares. Pode ser feito com grãos crus ou torrados    
ESPÉCIES CULTIVADAS
Arábica (Coffea arabica): tem sabor e aroma mais acentuados; é menos amarga e apresenta baixo teor de cafeína 
Robusta (Coffea canephora): tem o dobro do teor de cafeína do café arábica, além de sabor e aroma neutros; como sua solubilização é mais eficiente, é usada nos cafés solúveis 
BEBIDA
O café recebe classificações de acordo com o paladar: 
Mole: gosto doce e ácido 
Dura: gosto amargo e adstringente 
Riada: gosto ligeiramente químico 
Rio: gosto químico medicinal 
FRUTOS
O fruto do cafeeiro é formado por 
Casca: com o amadurecimento, passa de verde a vermelha ou amarela 
Polpa: situada logo após a casca, é bastante carnuda 
Mucilagem: camada viscosa, rica em açúcares, entre a polpa e o pergaminho 
Pergaminho: película interna, que envolve as sementes 
Sementes ou grãos: há duas em cada fruto 
AGROINDÚSTRIA
Derriça: forma mais comum de colheita no Brasil; todos os frutos são retirados dos galhos, maduros ou não, mecânica ou manualmente 
Secagem: a retirada de umidade do grão é feita para que os frutos não fermentem, e o sabor do café não se altere. Há três tipos de secagem (que são escolhidos também de acordo com o regime de chuvas da região), dos quais resultam os cafés: 
- Natural: o café é levado ao terreiro, onde é seco com a própria casca. O método, predominante no Brasil, origina uma bebida encorpada e doce 
- Cereja Descascado: separados das cascas, os frutos secam ao sol (a mucilagem migra para o grão). Resultam em cafés com corpo leve e boa acidez 
- Lavado: os frutos (maduros, que devem ter sido colhidos um a um, e não na derriça) são despolpados. Em um tanque, a mucilagem é fermentada. A bebida fica menos encorpada e mais ácida 
- Beneficiamento: após a secagem dos grãos, removem-se a casca externa dos cafés naturais e o pergaminho dos cafés lavados; o café resultante dessa etapa chama-se cru ou verde 
- Torrefação: o grão verde ou cru é aquecido, adquirindo coloração marrom; essa torra libera os aromas do café. 
- Moagem: os grãos, já torrados, são triturados, de acordo com a forma de preparo da bebida 
Pulverizado: café turco 
Fina: filtro de papel e coador de pano 
Média: expresso 
Grossa: cafeteira italiana 
CARDÁPIO 
- Expresso: preparado em máquinas, é extraído sob pressão (tem maior concentração de óleos aromáticos) 
- Longo ou carioca: café preparado com mais água; portanto, mais diluído 
- Curto: café preparado com menos água; ou seja, mais concentrado 
- Cappuccino: é preparado com um terço de café expresso, um terço de leite e um terço de espuma de leite (por aqui, utiliza-se também chocolate em pó) 
- Turco: modo árabe de tomar a bebida; o pó (pulverizado) é fervido com a água e posteriormente decantado
próximo...próxima ocorrência...
